##################
#                #
#   A      @o    #
#                #
##################