##################
#                #
#   A  @   @ oo  #
#                #
##################