#####
#o o#
# o #
#@@@#
#A  #
#####